NO images/512.xpm
SO images/ciel.xpm
WE images/miroirs_roses.xpm
EA images/miroirs_violet.xpm

F 226,100,0
C 225,30,-100

        11111   11111  11  111111
        1000111110111111111100001
        1011000001111110000000001
        1001000000001001000000001
111111111011000001111110000000001
100000000011000001110111111111111
11110111111111011100000010001
11110111111111011101010010001
11000000110101011100000010001
10000000000000000110000010001
10000000000W00001101010010001
110000011101010111110111100111
11110111 1110101 101111010001
11111111 1111111 111111111111
11111111 1111111 11111111