NO images/north.xpm
SO images/south.xpm
WE images/west.xpm
EA images/east.xpm

F 0,0,0
C 211,211,211


                   111111111
                   1100000011
                   1100000011
                   1110000111
                   11100011
        111111111111110011111111111
        100000011110000000000001111
        1100000111111110000000011
        1001000000001001000000001
111111111011000001111110000000001
        11111111111111111111S1111
