NO images/north.xpm
SO images/south.xpm
WE images/west.xpm
EA images/east.xpm

F 0,0,10000000000000000000000000000000000000000000000000
C 211,211,211

        11111111111111111111111111
        10000001111000000000000001
        10110S00011111100000000011
        1001000000001001000000001
111111111011000001111110000000001
        1111111111111111111111111